#######################################
# Syntax Coloring Map BLE
#######################################

#######################################
# Datatypes (KEYWORD1)
#######################################

BLE	KEYWORD1
BLEAddr	KEYWORD1
BLEAdvert	KEYWORD1
BLEAdvertData	KEYWORD1
iBeacon	KEYWORD1
altBeacon	KEYWORD1
BLECharacteristic	KEYWORD1
BLEClient	KEYWORD1
BLEConnect	KEYWORD1
BLEHIDDevice	KEYWORD1
BLEHIDGamepad	KEYWORD1
BLEHIDKeyboard	KEYWORD1
BLEHIDMouse	KEYWORD1
BLERemoteCharacteristic	KEYWORD1
BLERemoteDescriptor	KEYWORD1
BLERemoteService	KEYWORD1
BLEScan	KEYWORD1
BLESecurity	KEYWORD1
BLEService	KEYWORD1
BLEUUID	KEYWORD1
BLEWifiConfigService	KEYWORD1

#######################################
# BLEAddr Methods (KEYWORD2) & Constants (LITERAL1)
#######################################

str	KEYWORD2
data	KEYWORD2

#######################################
# BLEAdvert Methods (KEYWORD2) & Constants (LITERAL1)
#######################################

updateAdvertParams	KEYWORD2
startAdv	KEYWORD2
stopAdv	KEYWORD2
setAdvType	KEYWORD2
setMinInterval	KEYWORD2
setMaxInterval	KEYWORD2
setAdvData	KEYWORD2
setScanRspData	KEYWORD2

GAP_ADTYPE_ADV_IND	LITERAL1
GAP_ADTYPE_ADV_NONCONN_IND	LITERAL1
GAP_ADVCHAN_ALL	LITERAL1
GAP_ADV_FILTER_ANY	LITERAL1

#######################################
# BLEAdvertData Methods (KEYWORD2) & Constants (LITERAL1)
#######################################

clear	KEYWORD2
addData	KEYWORD2
addFlags	KEYWORD2
addPartialServices	KEYWORD2
addCompleteServices	KEYWORD2
addAppearance	KEYWORD2
addShortName	KEYWORD2
addCompleteName	KEYWORD2
parseScanInfo	KEYWORD2
hasFlags	KEYWORD2
hasUUID	KEYWORD2
hasName	KEYWORD2
hasManufacturer	KEYWORD2
getAdvType	KEYWORD2
getAddrType	KEYWORD2
getAddr	KEYWORD2
getRSSI	KEYWORD2
getFlags	KEYWORD2
getServiceCount	KEYWORD2
getServiceList	KEYWORD2
getName	KEYWORD2
getTxPower	KEYWORD2
getAppearance	KEYWORD2
getManufacturer	KEYWORD2
getManufacturerDataLength	KEYWORD2
getManufacturerData	KEYWORD2

GAP_GATT_APPEARANCE_UNKNOWN	LITERAL1
GAP_ADTYPE_FLAGS_LIMITED	LITERAL1
GAP_ADTYPE_FLAGS_BREDR_NOT_SUPPORTED	LITERAL1
T_LE_CB_DATA	LITERAL1
T_GAP_ADV_EVT_TYPE	LITERAL1
GAP_ADV_EVT_TYPE_UNDIRECTED	LITERAL1
GAP_ADV_EVT_TYPE_DIRECTED	LITERAL1
GAP_ADV_EVT_TYPE_SCANNABLE	LITERAL1
GAP_ADV_EVT_TYPE_NON_CONNECTABLE	LITERAL1
GAP_ADV_EVT_TYPE_SCAN_RSP	LITERAL1

#######################################
# BLEBeacon Methods (KEYWORD2) & Constants (LITERAL1)
#######################################

getManufacturerId	KEYWORD2
getUUID	KEYWORD2
getMajor	KEYWORD2
getMinor	KEYWORD2
getRSSI	KEYWORD2
getRSVD	KEYWORD2
setManufacturerId	KEYWORD2
setUUID	KEYWORD2
setMajor	KEYWORD2
setMinor	KEYWORD2
setRSSI	KEYWORD2
setRSVD	KEYWORD2
getAdvData	KEYWORD2
getScanRsp	KEYWORD2

advDataSize	LITERAL1
scanRspSize	LITERAL1

#######################################
# BLECharacteristic Methods (KEYWORD2) & Constants (LITERAL1)
#######################################

setUUID	KEYWORD2
getUUID	KEYWORD2
setBufferLen	KEYWORD2
getBufferLen	KEYWORD2
setReadProperty	KEYWORD2
setWriteProperty	KEYWORD2
setWriteNRProperty	KEYWORD2
setNotifyProperty	KEYWORD2
setIndicateProperty	KEYWORD2
setProperties	KEYWORD2
getProperties	KEYWORD2
setReadPermissions	KEYWORD2
setWritePermissions	KEYWORD2
setPermissions	KEYWORD2
getPermissions	KEYWORD2
readString	KEYWORD2
readData8	KEYWORD2
readData16	KEYWORD2
readData32	KEYWORD2
writeString	KEYWORD2
writeData8	KEYWORD2
writeData16	KEYWORD2
writeData32	KEYWORD2
setData	KEYWORD2
getData	KEYWORD2
getDataBuff	KEYWORD2
getDataLen	KEYWORD2
notify	KEYWORD2
indicate	KEYWORD2
setUserDescriptor	KEYWORD2
setFormatDescriptor	KEYWORD2
setReportRefDescriptor	KEYWORD2
setReadCallback	KEYWORD2
setWriteCallback	KEYWORD2
setCCCDCallback	KEYWORD2

GATT_CLIENT_CHAR_CONFIG_DEFAULT	LITERAL1
GATT_CLIENT_CHAR_CONFIG_NOTIFY	LITERAL1
GATT_CLIENT_CHAR_CONFIG_INDICATE	LITERAL1
GATT_CLIENT_CHAR_CONFIG_NOTIFY_INDICATE	LITERAL1

GATT_PERM_READ	LITERAL1
GATT_PERM_READ_AUTHEN_REQ	LITERAL1
GATT_PERM_READ_AUTHEN_MITM_REQ	LITERAL1
GATT_PERM_READ_AUTHOR_REQ	LITERAL1
GATT_PERM_READ_ENCRYPTED_REQ	LITERAL1
GATT_PERM_READ_AUTHEN_SC_REQ	LITERAL1

GATT_PERM_WRITE	LITERAL1
GATT_PERM_WRITE_AUTHEN_REQ	LITERAL1
GATT_PERM_WRITE_AUTHEN_MITM_REQ	LITERAL1
GATT_PERM_WRITE_AUTHOR_REQ	LITERAL1
GATT_PERM_WRITE_ENCRYPTED_REQ	LITERAL1
GATT_PERM_WRITE_AUTHEN_SC_REQ	LITERAL1

#######################################
# BLEClient Methods (KEYWORD2) & Constants (LITERAL1)
#######################################

connected	KEYWORD2
discoverService	KEYWORD2
discoveryDone	KEYWORD2
printServices	KEYWORD2
getService	KEYWORD2
getConnId	KEYWORD2
getClientId	KEYWORD2
setDisconnectCallback	KEYWORD2

T_CLIENT_ID	LITERAL1

#######################################
# BLEConnect Methods (KEYWORD2) & Constants (LITERAL1)
#######################################

connect	KEYWORD2
disconnect	KEYWORD2
setScanInterval	KEYWORD2
setScanWindow	KEYWORD2
setConnInterval	KEYWORD2
setConnLatency	KEYWORD2
setConnTimeout	KEYWORD2
updateConnParams	KEYWORD2
getConnInfo	KEYWORD2
getConnAddr	KEYWORD2
getConnId	KEYWORD2

T_GAP_REMOTE_ADDR_TYPE	LITERAL1
GAP_REMOTE_ADDR_LE_PUBLIC	LITERAL1
GAP_REMOTE_ADDR_LE_RANDOM	LITERAL1
T_GAP_CONN_INFO	LITERAL1

#######################################
# BLEDevice Methods (KEYWORD2) & Constants (LITERAL1)
#######################################

init	KEYWORD2
deinit	KEYWORD2
connected	KEYWORD2
setDeviceName	KEYWORD2
setDeviceAppearance	KEYWORD2
configAdvert	KEYWORD2
configScan	KEYWORD2
configConnection	KEYWORD2
configSecurity	KEYWORD2
setScanCallback	KEYWORD2
beginCentral	KEYWORD2
beginPeripheral	KEYWORD2
end	KEYWORD2
getLocalAddr	KEYWORD2
configServer	KEYWORD2
addService	KEYWORD2
configClient	KEYWORD2
addClient	KEYWORD2

#######################################
# BLEHIDDevice Methods (KEYWORD2) & Constants (LITERAL1)
#######################################

BLEHIDDev	KEYWORD2
init	KEYWORD2
setNumOutputReport	KEYWORD2
setNumInputReport	KEYWORD2
setReportMap	KEYWORD2
inputReport	KEYWORD2
setOutputReportCallback	KEYWORD2
bootKeyboardReport	KEYWORD2
setHidInfo	KEYWORD2
setBattLevel	KEYWORD2
setPNPInfo	KEYWORD2
setManufacturerString	KEYWORD2
setModelString	KEYWORD2
hidService	KEYWORD2
devInfoService	KEYWORD2
battService	KEYWORD2

HID_SERVICE_UUID	LITERAL1
GAP_GATT_APPEARANCE_HUMAN_INTERFACE_DEVICE	LITERAL1
GAP_GATT_APPEARANCE_KEYBOARD	LITERAL1
GAP_GATT_APPEARANCE_MOUSE	LITERAL1
GAP_GATT_APPEARANCE_JOYSTICK	LITERAL1
GAP_GATT_APPEARANCE_GAMEPAD	LITERAL1

#######################################
# BLEHIDGamepad Methods (KEYWORD2) & Constants (LITERAL1)
#######################################

setReportID	KEYWORD2
gamepadReport	KEYWORD2
buttonPress	KEYWORD2
buttonRelease	KEYWORD2
buttonReleaseAll	KEYWORD2
setHat	KEYWORD2
setAxes	KEYWORD2
setLeftStick	KEYWORD2
setRightStick	KEYWORD2
setTriggers	KEYWORD2

GAMEPAD_BUTTON_0	LITERAL1
GAMEPAD_BUTTON_1	LITERAL1
GAMEPAD_BUTTON_2	LITERAL1
GAMEPAD_BUTTON_3	LITERAL1
GAMEPAD_BUTTON_4	LITERAL1
GAMEPAD_BUTTON_5	LITERAL1
GAMEPAD_BUTTON_6	LITERAL1
GAMEPAD_BUTTON_7	LITERAL1
GAMEPAD_BUTTON_8	LITERAL1
GAMEPAD_BUTTON_9	LITERAL1
GAMEPAD_BUTTON_10	LITERAL1
GAMEPAD_BUTTON_11	LITERAL1
GAMEPAD_BUTTON_12	LITERAL1
GAMEPAD_BUTTON_13	LITERAL1
GAMEPAD_BUTTON_14	LITERAL1
GAMEPAD_BUTTON_15	LITERAL1
GAMEPAD_BUTTON_16	LITERAL1
GAMEPAD_BUTTON_17	LITERAL1
GAMEPAD_BUTTON_18	LITERAL1
GAMEPAD_BUTTON_19	LITERAL1
GAMEPAD_BUTTON_20	LITERAL1
GAMEPAD_BUTTON_21	LITERAL1
GAMEPAD_BUTTON_22	LITERAL1
GAMEPAD_BUTTON_23	LITERAL1
GAMEPAD_BUTTON_24	LITERAL1
GAMEPAD_BUTTON_25	LITERAL1
GAMEPAD_BUTTON_26	LITERAL1
GAMEPAD_BUTTON_27	LITERAL1
GAMEPAD_BUTTON_28	LITERAL1
GAMEPAD_BUTTON_29	LITERAL1
GAMEPAD_BUTTON_30	LITERAL1
GAMEPAD_BUTTON_31	LITERAL1

GAMEPAD_BUTTON_A	LITERAL1
GAMEPAD_BUTTON_SOUTH	LITERAL1
GAMEPAD_BUTTON_B	LITERAL1
GAMEPAD_BUTTON_EAST	LITERAL1
GAMEPAD_BUTTON_C	LITERAL1
GAMEPAD_BUTTON_X	LITERAL1
GAMEPAD_BUTTON_NORTH	LITERAL1
GAMEPAD_BUTTON_Y	LITERAL1
GAMEPAD_BUTTON_WEST	LITERAL1
GAMEPAD_BUTTON_Z	LITERAL1
GAMEPAD_BUTTON_TL	LITERAL1
GAMEPAD_BUTTON_TR	LITERAL1
GAMEPAD_BUTTON_TL2	LITERAL1
GAMEPAD_BUTTON_TR2	LITERAL1
GAMEPAD_BUTTON_SELECT	LITERAL1
GAMEPAD_BUTTON_START	LITERAL1
GAMEPAD_BUTTON_MODE	LITERAL1
GAMEPAD_BUTTON_THUMBL	LITERAL1
GAMEPAD_BUTTON_THUMBR	LITERAL1

GAMEPAD_HAT_CENTERED	LITERAL1
GAMEPAD_HAT_UP	LITERAL1
GAMEPAD_HAT_UP_RIGHT	LITERAL1
GAMEPAD_HAT_RIGHT	LITERAL1
GAMEPAD_HAT_DOWN_RIGHT	LITERAL1
GAMEPAD_HAT_DOWN	LITERAL1
GAMEPAD_HAT_DOWN_LEFT	LITERAL1
GAMEPAD_HAT_LEFT	LITERAL1
GAMEPAD_HAT_UP_LEFT	LITERAL1

#######################################
# BLEHIDKeyboard Methods (KEYWORD2) & Constants (LITERAL1)
#######################################

setReportID	KEYWORD2
consumerReport	KEYWORD2
keyboardReport	KEYWORD2
consumerPress	KEYWORD2
consumerRelease	KEYWORD2
keyPress	KEYWORD2
keyRelease	KEYWORD2
keyReleaseAll	KEYWORD2
keyCharPress	KEYWORD2
keySequence	KEYWORD2

HID_KEY_A	LITERAL1
HID_KEY_B	LITERAL1
HID_KEY_C	LITERAL1
HID_KEY_D	LITERAL1
HID_KEY_E	LITERAL1
HID_KEY_F	LITERAL1
HID_KEY_G	LITERAL1
HID_KEY_H	LITERAL1
HID_KEY_I	LITERAL1
HID_KEY_J	LITERAL1
HID_KEY_K	LITERAL1
HID_KEY_L	LITERAL1
HID_KEY_M	LITERAL1
HID_KEY_N	LITERAL1
HID_KEY_O	LITERAL1
HID_KEY_P	LITERAL1
HID_KEY_Q	LITERAL1
HID_KEY_R	LITERAL1
HID_KEY_S	LITERAL1
HID_KEY_T	LITERAL1
HID_KEY_U	LITERAL1
HID_KEY_V	LITERAL1
HID_KEY_W	LITERAL1
HID_KEY_X	LITERAL1
HID_KEY_Y	LITERAL1
HID_KEY_Z	LITERAL1
HID_KEY_1	LITERAL1
HID_KEY_2	LITERAL1
HID_KEY_3	LITERAL1
HID_KEY_4	LITERAL1
HID_KEY_5	LITERAL1
HID_KEY_6	LITERAL1
HID_KEY_7	LITERAL1
HID_KEY_8	LITERAL1
HID_KEY_9	LITERAL1
HID_KEY_0	LITERAL1
HID_KEY_ENTER	LITERAL1
HID_KEY_ESCAPE	LITERAL1
HID_KEY_BACKSPACE	LITERAL1
HID_KEY_TAB	LITERAL1
HID_KEY_SPACE	LITERAL1
HID_KEY_MINUS	LITERAL1
HID_KEY_EQUAL	LITERAL1
HID_KEY_BRACKET_LEFT	LITERAL1
HID_KEY_BRACKET_RIGHT	LITERAL1
HID_KEY_BACKSLASH	LITERAL1
HID_KEY_EUROPE_1	LITERAL1
HID_KEY_SEMICOLON	LITERAL1
HID_KEY_APOSTROPHE	LITERAL1
HID_KEY_GRAVE	LITERAL1
HID_KEY_COMMA	LITERAL1
HID_KEY_PERIOD	LITERAL1
HID_KEY_SLASH	LITERAL1
HID_KEY_CAPS_LOCK	LITERAL1
HID_KEY_F1	LITERAL1
HID_KEY_F2	LITERAL1
HID_KEY_F3	LITERAL1
HID_KEY_F4	LITERAL1
HID_KEY_F5	LITERAL1
HID_KEY_F6	LITERAL1
HID_KEY_F7	LITERAL1
HID_KEY_F8	LITERAL1
HID_KEY_F9	LITERAL1
HID_KEY_F10	LITERAL1
HID_KEY_F11	LITERAL1
HID_KEY_F12	LITERAL1
HID_KEY_PRINT_SCREEN	LITERAL1
HID_KEY_SCROLL_LOCK	LITERAL1
HID_KEY_PAUSE	LITERAL1
HID_KEY_INSERT	LITERAL1
HID_KEY_HOME	LITERAL1
HID_KEY_PAGE_UP	LITERAL1
HID_KEY_DELETE	LITERAL1
HID_KEY_END	LITERAL1
HID_KEY_PAGE_DOWN	LITERAL1
HID_KEY_ARROW_RIGHT	LITERAL1
HID_KEY_ARROW_LEFT	LITERAL1
HID_KEY_ARROW_DOWN	LITERAL1
HID_KEY_ARROW_UP	LITERAL1
HID_KEY_NUM_LOCK	LITERAL1
HID_KEY_KEYPAD_DIVIDE	LITERAL1
HID_KEY_KEYPAD_MULTIPLY	LITERAL1
HID_KEY_KEYPAD_SUBTRACT	LITERAL1
HID_KEY_KEYPAD_ADD	LITERAL1
HID_KEY_KEYPAD_ENTER	LITERAL1
HID_KEY_KEYPAD_1	LITERAL1
HID_KEY_KEYPAD_2	LITERAL1
HID_KEY_KEYPAD_3	LITERAL1
HID_KEY_KEYPAD_4	LITERAL1
HID_KEY_KEYPAD_5	LITERAL1
HID_KEY_KEYPAD_6	LITERAL1
HID_KEY_KEYPAD_7	LITERAL1
HID_KEY_KEYPAD_8	LITERAL1
HID_KEY_KEYPAD_9	LITERAL1
HID_KEY_KEYPAD_0	LITERAL1
HID_KEY_KEYPAD_DECIMAL	LITERAL1
HID_KEY_EUROPE_2	LITERAL1
HID_KEY_APPLICATION	LITERAL1
HID_KEY_POWER	LITERAL1
HID_KEY_KEYPAD_EQUAL	LITERAL1
HID_KEY_CONTROL_LEFT	LITERAL1
HID_KEY_SHIFT_LEFT	LITERAL1
HID_KEY_ALT_LEFT	LITERAL1
HID_KEY_GUI_LEFT	LITERAL1
HID_KEY_CONTROL_RIGHT	LITERAL1
HID_KEY_SHIFT_RIGHT	LITERAL1
HID_KEY_ALT_RIGHT	LITERAL1
HID_KEY_GUI_RIGHT	LITERAL1
HID_USAGE_CONSUMER_BRIGHTNESS_INCREMENT	LITERAL1
HID_USAGE_CONSUMER_BRIGHTNESS_DECREMENT	LITERAL1
HID_USAGE_CONSUMER_PLAY_PAUSE	LITERAL1
HID_USAGE_CONSUMER_SCAN_NEXT	LITERAL1
HID_USAGE_CONSUMER_SCAN_PREVIOUS	LITERAL1
HID_USAGE_CONSUMER_STOP	LITERAL1
HID_USAGE_CONSUMER_VOLUME	LITERAL1
HID_USAGE_CONSUMER_MUTE	LITERAL1
HID_USAGE_CONSUMER_VOLUME_INCREMENT	LITERAL1
HID_USAGE_CONSUMER_VOLUME_DECREMENT	LITERAL1

#######################################
# BLEHIDMouse Methods (KEYWORD2) & Constants (LITERAL1)
#######################################

setReportID	KEYWORD2
mouseReport	KEYWORD2
mousePress	KEYWORD2
mouseRelease	KEYWORD2
mouseReleaseAll	KEYWORD2
mouseMove	KEYWORD2
mouseScroll	KEYWORD2

MOUSE_BUTTON_LEFT	LITERAL1
MOUSE_BUTTON_RIGHT	LITERAL1
MOUSE_BUTTON_MIDDLE	LITERAL1
MOUSE_BUTTON_BACKWARD	LITERAL1
MOUSE_BUTTON_FORWARD	LITERAL1

#######################################
# BLERemoteCharacteristic Methods (KEYWORD2) & Constants (LITERAL1)
#######################################

getDescriptor	KEYWORD2
getUUID	KEYWORD2
setBufferLen	KEYWORD2
getBufferLen	KEYWORD2
canRead	KEYWORD2
canWrite	KEYWORD2
canNotify	KEYWORD2
canIndicate	KEYWORD2
getProperties	KEYWORD2
readString	KEYWORD2
readData8	KEYWORD2
readData16	KEYWORD2
readData32	KEYWORD2
writeString	KEYWORD2
writeData8	KEYWORD2
writeData16	KEYWORD2
writeData32	KEYWORD2
setData	KEYWORD2
getData	KEYWORD2
enableNotifyIndicate	KEYWORD2
disableNotifyIndicate	KEYWORD2
setNotifyCallback	KEYWORD2

#######################################
# BLERemoteDescriptor Methods (KEYWORD2) & Constants (LITERAL1)
#######################################

getUUID	KEYWORD2
setBufferLen	KEYWORD2
getBufferLen	KEYWORD2
readString	KEYWORD2
readData8	KEYWORD2
readData16	KEYWORD2
readData32	KEYWORD2
writeString	KEYWORD2
writeData8	KEYWORD2
writeData16	KEYWORD2
writeData32	KEYWORD2
setData	KEYWORD2
getData	KEYWORD2

#######################################
# BLERemoteService Methods (KEYWORD2) & Constants (LITERAL1)
#######################################

getUUID	KEYWORD2
getCharacteristic	KEYWORD2

#######################################
# BLEScan Methods (KEYWORD2) & Constants (LITERAL1)
#######################################

updateScanParams	KEYWORD2
startScan	KEYWORD2
stopScan	KEYWORD2
setScanMode	KEYWORD2
setScanInterval	KEYWORD2
setScanWindow	KEYWORD2
setScanDuplicateFilter	KEYWORD2
scanInProgress	KEYWORD2
printScanInfo	KEYWORD2

T_LE_CB_DATA	LITERAL1
GAP_SCAN_MODE_ACTIVE	LITERAL1
GAP_SCAN_MODE_PASSIVE	LITERAL1
GAP_SCAN_FILTER_DUPLICATE_ENABLE	LITERAL1
GAP_SCAN_FILTER_DUPLICATE_DISABLE	LITERAL1

#######################################
# BLESecurity Methods (KEYWORD2) & Constants (LITERAL1)
#######################################

setPairable	KEYWORD2
setAuthFlags	KEYWORD2
setIOCapability	KEYWORD2
setSecReqEnable	KEYWORD2
setSecReqFlags	KEYWORD2
setStaticPin	KEYWORD2
setPasskeyDisplayCallback	KEYWORD2
setPasskeyInputCallback	KEYWORD2
setNumericComparisonCallback	KEYWORD2

GAP_PAIRING_MODE_NO_PAIRING	LITERAL1
GAP_PAIRING_MODE_PAIRABLE	LITERAL1
GAP_AUTHEN_BIT_NONE	LITERAL1
GAP_AUTHEN_BIT_BONDING_FLAG	LITERAL1
GAP_AUTHEN_BIT_MITM_FLAG	LITERAL1
GAP_AUTHEN_BIT_SC_FLAG	LITERAL1
GAP_AUTHEN_BIT_SC_ONLY_FLAG	LITERAL1
GAP_AUTHEN_BIT_FORCE_BONDING_FLAG	LITERAL1
GAP_IO_CAP_DISPLAY_ONLY	LITERAL1
GAP_IO_CAP_DISPLAY_YES_NO	LITERAL1
GAP_IO_CAP_KEYBOARD_ONLY	LITERAL1
GAP_IO_CAP_NO_INPUT_NO_OUTPUT	LITERAL1
GAP_IO_CAP_KEYBOARD_DISPLAY	LITERAL1

#######################################
# BLEService Methods (KEYWORD2) & Constants (LITERAL1)
#######################################

setUUID	KEYWORD2
getUUID	KEYWORD2
addCharacteristic	KEYWORD2
getCharacteristic	KEYWORD2

#######################################
# BLEUUID Methods (KEYWORD2) & Constants (LITERAL1)
#######################################

str	KEYWORD2
data	KEYWORD2
dataNative	KEYWORD2
length	KEYWORD2

#######################################
# BLEWifiConfigService Methods (KEYWORD2) & Constants (LITERAL1)
#######################################

begin	KEYWORD2
end	KEYWORD2
addService	KEYWORD2
advData	KEYWORD2

#######################################
# Constants (LITERAL1)
#######################################
